11111111111111111111111
100P00000000000C0000001
1011100000C111111111001
10000000000000000000001
10001111000011111111001
100000000000000C1000001
10000000000000000000001
10111111111111001111001
10001111110000000000001
1000000000000000C000001
10000000000000000000001
10001100001111000000001
10000000000000000000001
100000000C0000000000001
100E1111111111111000001
10000000000000000000001
11111111111111111111111