11111111111111
1000000010E000
11110000000001
100000K0000001
11111111111111