1111111111111
101C0000PC001
1000011111001
100C11E000001
1111111111111