11111111111111
1000P00010E001
111100C0000C01
10000010000001
11111111111111